-10
4
-7
5
012121212122221
002220022221122
212121012102221
222222222001122
012121212122221
002222222221122
212121212102221
222222222002121
012121212121121
002221222220121
212122121012121
002212220022111
012122121212111
