-10
4
-7
5
010101010100001
000000000001100
010101010100001
000000000001100
010101010100001
000000000001100
010101010100001
000000000000101
010101010101101
000001000000101
010100101010101
000010000000111
010100101010111
