-10
4
-7
5
010101010100001
000000000001100
010101010100001
000000000001100
010101010100001
000000000001100
010101010100001
000000000000101
010101000101101
000001000000101
010100101010101
000010000000111
010100101010111
002020202023230
003230023230023
202020002003230
323232323000023
002020202023230
003232321230023
202020202003230
323232323002020
002020202020030
003210323230020
202023020001030
003202320032000
002032030302000
